#..............................#
#........#########.............#
#.########.........#######.....#
#..............................#
#""""""""""""""""""""""""""""""#
