#................#
#.......##.......#
#####...........##
#................#
#...#####.#####..#
##...............#
#................#
#..#.....#......##
#................#
#.....#..........#
#.......#.....#..#
#...........#....#
#.........#......#
#................#
#.#..#..#........#
#................#
#................#
#........#######.#
#................#
#....##..........#
#.........########
#................#
#########........#
#................#
#..........#######
#.......###......#
#................#
#######....##....#
#................#
#........#########
#.......#........#
##..##...........#
#................#
#.....#####.....##
#.......#........#
#.......#.......##
######..#....#...#
#.......##.......#
#.......#...#....#
#..#.####........#
##......#...######
#................#
#................#
############.....#
#................#
#................#
#........#####...#
#.....##..#......#
#.........#......#
#####.....#..##..#
#.......#.#......#
#.........#......#
#.........#....###
#..#####..#......#
#.........####...#
#.........#......#
#######...#....###
#................#
#.....########...#
#................#
#................#
#.......##...###.#
#..........#.....#
#...###..........#
#................#
#########........#
#................#
#..........#######
#........##......#
#................#
#######..........#
#................#
#........#########
#................#
#....##..........#
#................#
#.........###....#
#..#####.........#
#................#
#................#
#.#......#########
########.........#
#...........##...#
#..######........#
#................#
#.........######.#
#....##..........#
#................#
#........####....#
#..#####.........#
#................#
#................#
#.#......#########
########.........#
#...........##...#
#..######........#
#.........####...#
#................#
#...........x....#
#""""""""""""""""#
