#...........................#
#.##........................#
#........#####....##........#
#.##...........x............#
#"""""""""""""""""""""""""""#
