
#................#
#................#
#................#
#................#
#................#
#................#
#................#
#................#
#................#
#................#
#................#
#................#
#................#
#................#
#................#
#................#
#................#
#................#
#................#
#................#
#................#
#................#
#................#
#................#
#................#
#................#
#................#
#................#
#................#
#................#
#................#
#................#
#................#
#................#
#................#
#................#
#................#
#................#
#................#
#................#
#................#
#................#
#................#
#................#
#................#
#................#
#................#
#................#
#................#
#................#
#................#
#................#
#................#
#................#
#................#
#................#
#................#
#................#
#................#
#................#
#................#
#................#
#................#
#................#
#................#
#................#
#................#
#................#
#................#
#................#
#................#
#................#
#................#
#................#
#................#
#................#
#................#
#................#
#................#
#................#
#................#
#................#
#................#
#.........####...#
#................#
#..####..........#
#................#
#....##..........#
#.......##.......#
#.............####
#...###..........#
#................#
#.....##....##...#
#...##...........#
#........##......#
#...........#.#.##
#.....##....#.#..#
#.....##....#.#..#
#""""""""""""""."#
