#.........########
#........#c......#
#.p.......##....x#
#####...x.#.....##
#......####......#
#...........##...#
#................#
#.#####.......####
#..........#.....#
#......x.........#
#.....#####......#
#................#
#.............####
#..###...........#
#.#........#.....#
#.....x..#..#x...#
#.....##.....#...#
##............#..#
#...x#...........#
#...#...........c#
#..........##..###
##...............#
#................#
#...#............#
#x...............#
##...............#
#................#
#................#
#...#....#.......#
#................#
#......#.....x...#
#............##..#
#................#
#....#....#......#
#................#
#................#
#..#.....###.....#
#................#
#................#
#..###...........#
#.......###......#
#.c.....#.......##
#...........##...#
######...........#
#................#
#......#..########
#x...............#
######...........#
#..........##....#
#................#
#.....##........x#
#.............####
#x...............#
#####............#
#.......x........#
#......##........#
#................#
#...........#....#
#................#
#.......#######..#
#................#
#######..........#
#................#
#..#..######.....#
#x..............x#
###............###
#......#.........#
#...........#....#
#....#...........#
#................#
#......#####.....#
###..............#
#................#
#..##............#
#.....####.......#
#x.......x.......#
##......####.....#
#................#
#.........####...#
#................#
#####...##.......#
#...........x....#
#.........########
#................#
#...#...##.......#
#................#
##.x.............#
#..##............#
#........####....#
#.x..............#
#######..........#
#...............x#
#........####...##
#................#
#.............####
#.....x..........#
#.....##....###..#
#................#
#..#........x....#
#""""""""""""""""#
