#............................#
#............................#
#............................#
#............................#
#............................#
#............................#
#............................#
#............................#
#............................#
#............................#
#............................#
#............................#
#.....................####...#
#............................#
#..###########...............#
#............................#
#................##..........#
#....................##......#
#.........................####
#...........###..............#
#............................#
#.......##.............##....#
#...##.......................#
#................#....#......#
#................#....#....###
#.......##.......#....#......#
#.##....##.......#....#......#
""""""""""""""""""    """"""""
