#................#
#................#
#................#
#................#
#................#
#................#
#................#
#................#
#................#
#................#
#................#
#................#
#................#
#................#
#................#
#................#
#................#
#................#
#................#
#................#
#................#
#................#
#................#
#................#
#................#
#................#
#................#
#................#
#................#
#................#
#................#
#................#
#................#
#................#
#................#
#................#
#................#
#................#
#................#
#................#
#................#
#................#
#................#
#................#
#................#
#................#
#................#
#................#
#................#
#................#
#................#
#................#
#................#
#................#
#................#
#................#
#................#
#................#
#..p.............#
#................#
#................#
#######..........#
#................#
#.....######.....#
#x...............#
###............###
#......#.........#
#...........#....#
#....#...........#
#................#
#......#####.....#
###..............#
#................#
#..##............#
#.....####.......#
#x...............#
##......####.....#
#................#
#.........####...#
#................#
#####...##.......#
#...........x....#
#.........########
#................#
####.............#
#...x..##........#
#..##............#
#................#
#.......#####....#
#.x..............#
#######..........#
#...............x#
#.......####....##
#................#
#.............####
#.....x..........#
#.....##....###..#
#................#
#..#........x....#
#""""""""""""""""#
