#...........................#
#.##........................#
#........#####....##........#
#.##........................#
#"""""""""""""""""""""""""""#
